#############################
#                           #
#  #####                    #
#                   ####    #
#                           #
#       ###                 #
#                  ##       #
#                           #
#    # #       ######       #
#    # #                    #
#    # #                    #
#    # ##                   #
#    #                      #
#    ####                   #
#                  #######  #
#                           #
#############################