########################################################################################
#                                                                                      #
########                                                                               #
#      #                                                                        ########
#      #                                                                        #      #
#      ####                                                                     #      #
#                                                                               #      #
#                                                                               #      #
#    #  ###################                                               #######      #
#    #  #                                                                              #
#    #  #                                                                              #
#    #  ######                                                                         #
#    #                                                                                 # 
#    #                                                                                 #
#    #########                                                                         #
#                                                                        ###############
#                                                                        #             #
#                                                                        #             #
#                                                                        #             #
#                                                                        #             #
#                                                                        #             #
#                                                                        #             #
#                                                                        #             #
#                                                                        #             #
#                                                                        #             #
#                                                                        #             #
########################################################################################